2
7
7
#######
#.   .#
#.$$$.#
##$@$##
#.$$$.#
#.   .#
#######
