5
7
7
 #####
##. .##
#.$$$.#
# $@$ #
#.$$$.#
##. .##
 #####
