7
8
5
########
#.  $ .#
#.$$$$.#
#. @$ .#
########
