8
9
9
#########
#.     .#
# #   # #
# .$$$. #
#  $@$  #
# .$$$. #
# #   # #
#.     .#
#########
